Autores dos livros:

- O Príncipe: Nicolau Maquiavel
- Mindset: Carol S. Dweck
- Initial D - Vol.10 - Shuichi Shigeno
- Hunter x Hunter - Vol.34 - Yoshihiro Togashi
- Vagabond - Takehiko Inoue
- A Biblioteca da Meia-Noite - Matt Haig
- Imperfeitos - Christina Lauren
- O Hobbit - J.R.R Tolkien
- Arte da Guerra - Sun Tzu
- O Contrato Social - Jean-Jacques-Rousseau
- Nunca Deixe de Tentar - Michael Jordan
- O Eternauta - Héctor Oesterheld, Francisco Solano López
- Harry Potter e a Pedra Filosofal - J.K Rowling
- Orgulho e Preconceito - Jane Austen
- 1984 - George Orwell
- Memórias Póstumas de Brás Cubas - Machado de Assis
- O Pequeno Príncipe - Antoine de Saint-Exupéry
- Os Miseráveis - Victor Hugo
- O Clube do Crime das Quintas-Feiras - Richard Osman
- O Natal de Poirot - Agatha Christie
- Os Três Mosqueteiros - Alexandre Dumas
- Diário de um Banana 1 - Jeff Kinney
- Frankenstein - Mary Shelley
- Fundamentos da Matemática Elementar 8 - Gelson Iezzi, Carlos Murakami
- Tópicos de Física 1 - Ricardo Helou Doca, Gualter José Biscuola, Newton Vilas Bôas
- Percy Jackson: Ladrão de Raios - Rick Riordan
- Star Wars: A Trilogia (Dark Edition) - George Lucas
- O senhor dos Anéis: A Sociedade do Anel - J.R.R Tolkien
- O médico e o Monstro - Robert Louis Stevenson
- Bleach - Vol.6 - Tite Kubo
- Introdução à Linguagem SQL - Thomas Nield



